00000000000000000000
11111101111000111110
00011111011100100010
01111101001111101110
01100001101111001100
01111111100001011000
01111111110111111110
01100000110011100010
00111011111111111010
00100000110111001110
00111111110001101010
01110000111111111110
01011111110111101010
01001001110111101010
01101101000001101010
00101101110111111110
00111100000101111110
00100111101101111000
00111100111001111111
00000000000000000000
