00000000000000000000
11111111111111111110
01111010000001010110
01001010111101010110
01011011111111010110
01010010001000010010
01111110111111111010
01001000110111111010
01111110110000001010
01000000111111101010
01111111111111111110
01000111111000100010
01010100011010101110
01010101111011101010
01010101011010001010
01010111011000111010
01010001011111111110
01011101000001000010
01111111111111111111
00000000000000000000
