00000000000000000000
01000110000000000000
01010110000000000000
01110110000000000000
01010110000000000000
01011111111000000000
01010111111000000000
11110000011111110000
00100001111000010000
00111101111011010010
00111111111111110010
00111101111000111110
00111101111110100010
00010001000111111111
01110111000000011010
01000101000000011010
01111101000000011110
01110001000000010110
01111111000000010110
00000000000000000000
