00000000000000000000
11111111111111111110
00000000000000000010
01111111111111111010
01010000000000101010
01011101111110101010
01010101001011111010
01010101111010001010
01010111000010101010
01010101011110101010
01010101111010101010
01010101000011101010
01010001011110101010
01011111010010101010
01010101111110111010
01010100000000001010
01011111111111111110
01000000000000000000
01111111111111111111
00000000000000000000
