00000000000000000000
11111111111111111110
01000010000000010010
01111111111111111010
01000010000001001010
01111111111111101010
01010010000100101010
01011111111110101010
01010100010010111110
01010111011010101010
01010101011011101010
01111101001000101010
01010101111111111010
01010100100001001010
01010111111111111110
01010010000001000010
01011111111111111110
01001000000001000010
01111111111111111111
00000000000000000000
