00000000000000000000
11111100000000000000
00000100000000000000
00000100000000000000
00000100000000000000
00000100000000000000
00000100000000000000
00000100000111000000
00000100000101000000
00000100011101000000
00000100010001000000
00000111111111111111
00000100010000000000
00000100010000000000
00000111110000000000
00000000000000000000
00000000000000000000
00000000000000000000
00000000000000000000
00000000000000000000
