00000000000000000000
01110101011111111110
01010101010000000000
01011101110111111110
01000001000100000000
01111111011101111110
00010001110001000010
11111101000111011110
00000101010100010000
01111101010111110000
01000001110101011111
01011111010101000000
01110000010101111110
01011111010111000010
01000001100000011110
01011100110111010000
01010100010101011110
01010101010101000010
01110111011101111110
00000000000000000000
